R 1000 1000

NO ./textures/eagle(128).xpm

SO ./textures/mossystone.xpm

WE ./textures/bluestone.xpm

EA ./textures/colorstone.xpm

S ./textures/pillar.xpm

F 88, 88, 88

C 44, 44, 44

       1111111111111111111111111
       1000020000110200002000001
       1011000001110200002000001
       10010002000000000000000001
111111111011000001110000020000001
10000000001100S001110111110111111
11100000000000000000000000001
111000000001111110000000000001
110000000001    1000000000001
10000000000111111000000000001
100000000000000000000000000001
110000011101010111110111100111
11110111 1110101 101111010001
11111111 1111111 111111111111