R 1000 1000

NO ./textures/eagle.xpm

SO ./textures/mossystone.xpm

WE ./textures/bluestone.xpm

EA ./textures/colorstone.xpm

S ./textures/barrel.xpm

F 88, 88, 88

C 44,44,44


1111111111111111111111111
1002002002002002002002001
1000000000000000000000001
1002002002002002002002001
1000000000000000000000001
1002002002002002002002001
1000000000000000000000001
1002002002002002002002001
1000000000000000000000001
1002002002002002002002001
1000000000S00000000000001
1002002002002002002002001
1000000000000000000000001
1002002002002002002002001
1000000000000000000000001
1002002002002002002002001
1000000000000000000000001
1002002002002002002002001
1000000000000000000000001
1002002002002002002002001
1000000000000000000000001
1002002002002002002002001
1000000000000000000000001
1002002002002002002002001
1000000000000000000000001
1002002002002002002002001
1000000000000000000000001
1002002002002002002002001
1000000000000000000000001
1002002002002002002002001
1000000000000000000000001
1002002002002002002002001
1000000000000000000000001
1002002002002002002002001
1000000000000000000000001
1111111111111111111111111