R 800 800
NO ./textures/sample(1920)(1280).xpm
SO ./textures/sample(640)(426).xpm

WE ./textures/sample(5184)(3456).xpm

EA ./textures/eagle.xpm

S ./textures/barrel.xpm

C 44, 44, 9

F 88,       100,           100

111111
1011N1
111111
