R 500 500

SO ./textures/mossystone.xpm

WE ./textures/bluestone.xpm

EA ./textures/colorstone.xpm

NO ./textures/eagle.xpm

S ./textures/pillar.xpm

F 88, 88, 88

C 44, 44, 44

       1111111111111111111111111
       1000000000110200002000001
       1011002001110200002000001
       10010020000000000000000W01
111111111011000001110000020000001
100000000011000001110111110111111
11110111111111011100000010001
11110111111111011101010010001
11000000110101011100000010001
10000000000000001100000010001
10000000000000001101010010001
110000011101010111110111100111
11110111 1110101 101111010001
11111111 1111111 111111111111
