R 50 50

NO ./textures/eagle.xpm

SO ./textures/mossystone.xpm

WE ./textures/bluestone.xpm

EA ./textures/colorstone.xpm

S ./textures/barrel.xpm

F 88, 88, 88

C 44,44,44

       1111111111111111111111111
       1000020000110200002000001
       1011000001110200002000001
       10010002000000000000000W01
111111111011000001110000020000001
100000000011000001110111110111111
11110111111111011100000010001
11110111111111011101010010001
11000000110101011100000010001
10002000000000001100000010001
10000000000000001101010010001
110000011101010111110111100111
11110111 1110101 101111010001
11111111 1111111 111111111111